{
  "name": "Pallet Town",
  "width": 20,
  "height": 18,
  "tileset": "overworld",
  "layers": [
    [
      [5, 5, 5, 5, 5, 5, 5, 5, 5, 5, 5, 5, 5, 5, 5, 5, 5, 5, 5, 5],
      [5, 0, 0, 0, 0, 0, 0, 0, 0, 1, 1, 0, 0, 0, 0, 0, 0, 0, 0, 5],
      [5, 0, 6, 6, 6, 0, 0, 0, 0, 1, 1, 0, 0, 0, 6, 6, 6, 6, 0, 5],
      [5, 0, 6, 6, 6, 0, 0, 0, 0, 1, 1, 0, 0, 0, 6, 6, 6, 6, 0, 5],
      [5, 0, 0, 0, 0, 0, 0, 0, 0, 1, 1, 0, 0, 0, 0, 0, 0, 0, 0, 5],
      [5, 0, 0, 3, 3, 3, 0, 0, 0, 1, 1, 0, 0, 3, 3, 3, 3, 0, 0, 5],
      [5, 0, 0, 3, 4, 3, 0, 0, 0, 1, 1, 0, 0, 3, 4, 4, 3, 0, 0, 5],
      [5, 0, 0, 3, 1, 3, 0, 0, 0, 1, 1, 0, 0, 3, 4, 4, 3, 0, 0, 5],
      [5, 0, 0, 0, 1, 0, 0, 0, 1, 1, 1, 1, 0, 3, 1, 1, 3, 0, 0, 5],
      [5, 1, 1, 1, 1, 1, 1, 1, 1, 1, 1, 1, 1, 1, 1, 1, 1, 1, 1, 5],
      [5, 0, 0, 0, 0, 0, 0, 0, 1, 1, 1, 1, 0, 0, 0, 0, 0, 0, 0, 5],
      [5, 0, 0, 0, 0, 0, 0, 0, 0, 1, 1, 0, 0, 0, 0, 0, 0, 0, 0, 5],
      [5, 0, 6, 6, 0, 0, 0, 0, 0, 1, 1, 0, 0, 0, 6, 6, 6, 0, 0, 5],
      [5, 0, 6, 6, 0, 0, 0, 0, 0, 1, 1, 0, 0, 0, 6, 6, 6, 0, 0, 5],
      [5, 0, 0, 0, 0, 0, 0, 0, 0, 1, 1, 0, 0, 0, 0, 0, 0, 0, 0, 5],
      [5, 0, 0, 0, 0, 0, 0, 0, 0, 1, 1, 0, 0, 0, 0, 0, 0, 0, 0, 5],
      [5, 2, 2, 2, 2, 2, 2, 2, 2, 2, 2, 2, 2, 2, 2, 2, 2, 2, 2, 5],
      [5, 5, 5, 5, 5, 5, 5, 5, 5, 5, 5, 5, 5, 5, 5, 5, 5, 5, 5, 5]
    ]
  ],
  "collision": [
    [1, 1, 1, 1, 1, 1, 1, 1, 1, 1, 1, 1, 1, 1, 1, 1, 1, 1, 1, 1],
    [1, 0, 0, 0, 0, 0, 0, 0, 0, 0, 0, 0, 0, 0, 0, 0, 0, 0, 0, 1],
    [1, 0, 0, 0, 0, 0, 0, 0, 0, 0, 0, 0, 0, 0, 0, 0, 0, 0, 0, 1],
    [1, 0, 0, 0, 0, 0, 0, 0, 0, 0, 0, 0, 0, 0, 0, 0, 0, 0, 0, 1],
    [1, 0, 0, 0, 0, 0, 0, 0, 0, 0, 0, 0, 0, 0, 0, 0, 0, 0, 0, 1],
    [1, 0, 0, 1, 1, 1, 0, 0, 0, 0, 0, 0, 0, 1, 1, 1, 1, 0, 0, 1],
    [1, 0, 0, 1, 1, 1, 0, 0, 0, 0, 0, 0, 0, 1, 1, 1, 1, 0, 0, 1],
    [1, 0, 0, 1, 0, 1, 0, 0, 0, 0, 0, 0, 0, 1, 1, 1, 1, 0, 0, 1],
    [1, 0, 0, 0, 0, 0, 0, 0, 0, 0, 0, 0, 0, 1, 0, 0, 1, 0, 0, 1],
    [1, 0, 0, 0, 0, 0, 0, 0, 0, 0, 0, 0, 0, 0, 0, 0, 0, 0, 0, 1],
    [1, 0, 0, 0, 0, 0, 0, 0, 0, 0, 0, 0, 0, 0, 0, 0, 0, 0, 0, 1],
    [1, 0, 0, 0, 0, 0, 0, 0, 0, 0, 0, 0, 0, 0, 0, 0, 0, 0, 0, 1],
    [1, 0, 0, 0, 0, 0, 0, 0, 0, 0, 0, 0, 0, 0, 0, 0, 0, 0, 0, 1],
    [1, 0, 0, 0, 0, 0, 0, 0, 0, 0, 0, 0, 0, 0, 0, 0, 0, 0, 0, 1],
    [1, 0, 0, 0, 0, 0, 0, 0, 0, 0, 0, 0, 0, 0, 0, 0, 0, 0, 0, 1],
    [1, 0, 0, 0, 0, 0, 0, 0, 0, 0, 0, 0, 0, 0, 0, 0, 0, 0, 0, 1],
    [1, 1, 1, 1, 1, 1, 1, 1, 1, 1, 1, 1, 1, 1, 1, 1, 1, 1, 1, 1],
    [1, 1, 1, 1, 1, 1, 1, 1, 1, 1, 1, 1, 1, 1, 1, 1, 1, 1, 1, 1]
  ],
  "warps": [
    {
      "x": 4,
      "y": 7,
      "target_map": "player_house",
      "target_x": 3,
      "target_y": 7
    },
    {
      "x": 14,
      "y": 8,
      "target_map": "oak_lab",
      "target_x": 4,
      "target_y": 11
    },
    {
      "x": 15,
      "y": 8,
      "target_map": "oak_lab",
      "target_x": 5,
      "target_y": 11
    },
    {
      "x": 9,
      "y": 1,
      "target_map": "route_1",
      "target_x": 9,
      "target_y": 35
    },
    {
      "x": 10,
      "y": 1,
      "target_map": "route_1",
      "target_x": 10,
      "target_y": 35
    }
  ],
  "npcs": [
    {
      "name": "Girl",
      "x": 6,
      "y": 4,
      "facing": "down",
      "dialogue": ["I'm raising Pokemon too!", "When they get strong, we should battle!"],
      "wanders": false
    },
    {
      "name": "Old Man",
      "x": 12,
      "y": 11,
      "facing": "left",
      "dialogue": ["Technology is incredible!", "You can now store and recall Pokemon anywhere!"],
      "wanders": true
    }
  ],
  "encounters": [
    {"pokemon": "RATTATA", "level_min": 2, "level_max": 4, "rate": 60},
    {"pokemon": "PIDGEY", "level_min": 2, "level_max": 4, "rate": 40}
  ]
}
