{
  "name": "Route 1",
  "width": 20,
  "height": 36,
  "tileset": "overworld",
  "layers": [
    [
      [5, 5, 5, 5, 5, 5, 5, 5, 5, 5, 5, 5, 5, 5, 5, 5, 5, 5, 5, 5],
      [5, 0, 0, 0, 0, 0, 0, 0, 0, 1, 1, 0, 0, 0, 0, 0, 0, 0, 0, 5],
      [5, 0, 6, 6, 6, 6, 0, 0, 0, 1, 1, 0, 0, 6, 6, 6, 6, 6, 0, 5],
      [5, 0, 6, 6, 6, 6, 0, 0, 0, 1, 1, 0, 0, 6, 6, 6, 6, 6, 0, 5],
      [5, 0, 6, 6, 6, 6, 0, 0, 0, 1, 1, 0, 0, 6, 6, 6, 6, 6, 0, 5],
      [5, 0, 0, 0, 0, 0, 0, 0, 0, 1, 1, 0, 0, 0, 0, 0, 0, 0, 0, 5],
      [5, 0, 0, 0, 0, 0, 0, 0, 1, 1, 1, 1, 0, 0, 0, 0, 0, 0, 0, 5],
      [5, 0, 6, 6, 6, 0, 0, 1, 1, 1, 1, 1, 1, 0, 6, 6, 6, 0, 0, 5],
      [5, 0, 6, 6, 6, 0, 0, 1, 1, 0, 0, 1, 1, 0, 6, 6, 6, 0, 0, 5],
      [5, 0, 6, 6, 6, 0, 0, 1, 1, 0, 0, 1, 1, 0, 6, 6, 6, 0, 0, 5],
      [5, 0, 0, 0, 0, 0, 0, 1, 1, 0, 0, 1, 1, 0, 0, 0, 0, 0, 0, 5],
      [5, 0, 0, 0, 0, 0, 0, 1, 1, 0, 0, 1, 1, 0, 0, 0, 0, 0, 0, 5],
      [5, 0, 6, 6, 0, 0, 0, 1, 1, 1, 1, 1, 1, 0, 0, 6, 6, 0, 0, 5],
      [5, 0, 6, 6, 0, 0, 0, 0, 1, 1, 1, 1, 0, 0, 0, 6, 6, 0, 0, 5],
      [5, 0, 0, 0, 0, 0, 0, 0, 0, 1, 1, 0, 0, 0, 0, 0, 0, 0, 0, 5],
      [5, 0, 0, 0, 0, 0, 0, 0, 0, 1, 1, 0, 0, 0, 0, 0, 0, 0, 0, 5],
      [5, 0, 6, 6, 6, 6, 0, 0, 0, 1, 1, 0, 0, 6, 6, 6, 6, 0, 0, 5],
      [5, 0, 6, 6, 6, 6, 0, 0, 0, 1, 1, 0, 0, 6, 6, 6, 6, 0, 0, 5],
      [5, 0, 6, 6, 6, 6, 0, 0, 0, 1, 1, 0, 0, 6, 6, 6, 6, 0, 0, 5],
      [5, 0, 0, 0, 0, 0, 0, 0, 0, 1, 1, 0, 0, 0, 0, 0, 0, 0, 0, 5],
      [5, 0, 0, 0, 0, 0, 0, 0, 0, 1, 1, 0, 0, 0, 0, 0, 0, 0, 0, 5],
      [5, 0, 0, 0, 0, 0, 0, 0, 1, 1, 1, 1, 0, 0, 0, 0, 0, 0, 0, 5],
      [5, 0, 6, 6, 6, 0, 0, 1, 1, 0, 0, 1, 1, 0, 6, 6, 6, 0, 0, 5],
      [5, 0, 6, 6, 6, 0, 0, 1, 1, 0, 0, 1, 1, 0, 6, 6, 6, 0, 0, 5],
      [5, 0, 6, 6, 6, 0, 0, 1, 1, 0, 0, 1, 1, 0, 6, 6, 6, 0, 0, 5],
      [5, 0, 0, 0, 0, 0, 0, 1, 1, 1, 1, 1, 1, 0, 0, 0, 0, 0, 0, 5],
      [5, 0, 0, 0, 0, 0, 0, 0, 1, 1, 1, 1, 0, 0, 0, 0, 0, 0, 0, 5],
      [5, 0, 6, 6, 0, 0, 0, 0, 0, 1, 1, 0, 0, 0, 6, 6, 0, 0, 0, 5],
      [5, 0, 6, 6, 0, 0, 0, 0, 0, 1, 1, 0, 0, 0, 6, 6, 0, 0, 0, 5],
      [5, 0, 0, 0, 0, 0, 0, 0, 0, 1, 1, 0, 0, 0, 0, 0, 0, 0, 0, 5],
      [5, 0, 0, 0, 0, 0, 0, 0, 0, 1, 1, 0, 0, 0, 0, 0, 0, 0, 0, 5],
      [5, 0, 6, 6, 6, 6, 0, 0, 0, 1, 1, 0, 0, 6, 6, 6, 6, 0, 0, 5],
      [5, 0, 6, 6, 6, 6, 0, 0, 0, 1, 1, 0, 0, 6, 6, 6, 6, 0, 0, 5],
      [5, 0, 6, 6, 6, 6, 0, 0, 0, 1, 1, 0, 0, 6, 6, 6, 6, 0, 0, 5],
      [5, 0, 0, 0, 0, 0, 0, 0, 0, 1, 1, 0, 0, 0, 0, 0, 0, 0, 0, 5],
      [5, 5, 5, 5, 5, 5, 5, 5, 5, 5, 5, 5, 5, 5, 5, 5, 5, 5, 5, 5]
    ]
  ],
  "warps": [
    {
      "x": 9,
      "y": 35,
      "target_map": "pallet_town",
      "target_x": 9,
      "target_y": 1
    },
    {
      "x": 10,
      "y": 35,
      "target_map": "pallet_town",
      "target_x": 10,
      "target_y": 1
    },
    {
      "x": 9,
      "y": 0,
      "target_map": "viridian_city",
      "target_x": 9,
      "target_y": 35
    },
    {
      "x": 10,
      "y": 0,
      "target_map": "viridian_city",
      "target_x": 10,
      "target_y": 35
    }
  ],
  "npcs": [
    {
      "name": "Youngster",
      "x": 12,
      "y": 15,
      "facing": "left",
      "dialogue": ["I just caught a PIDGEY!", "Want to see it?"],
      "wanders": false
    }
  ],
  "encounters": [
    {"pokemon": "RATTATA", "level_min": 2, "level_max": 4, "rate": 50},
    {"pokemon": "PIDGEY", "level_min": 2, "level_max": 5, "rate": 50}
  ]
}
